4,7,7,7,7,7,7,7,7,7,7,4,44,44,44,44,
6,0,1,2,3,4,5,6,7,8,9,14,44,44,44,44,
6,10,11,12,13,14,15,16,17,18,19,14,44,44,44,44,
6,20,21,22,23,24,25,26,27,28,29,14,44,44,44,44,
6,30,31,32,33,34,35,36,37,38,39,14,44,44,44,44,
6,40,41,42,43,44,45,46,47,48,49,14,44,44,44,44,
6,50,44,44,44,44,44,44,44,44,44,14,44,44,44,44,
6,44,44,44,44,44,44,44,44,44,44,14,44,44,44,44,
6,44,44,44,44,44,44,44,44,44,44,14,44,44,44,44,
6,44,44,44,44,44,44,44,44,44,44,14,44,44,44,44,
6,44,44,44,44,44,44,44,44,44,44,14,44,44,44,44,
6,44,44,44,44,44,44,44,44,44,44,14,44,44,44,44,
6,44,44,44,44,44,44,44,44,44,44,14,44,44,44,44,
6,44,44,44,44,44,44,44,44,44,44,14,44,44,44,44,
6,5,5,5,5,5,5,5,5,5,5,4,44,44,44,44,