44,44,44,44,44,44,44,44,44,44,44,44,44,44,44,44
44,44,44,44,44,44,44,44,44,42,43,44,44,22,44,44
44,44,44,44,44,44,44,44,44,16,17,44,44,44,44,44
44,44,44,44,44,44,44,44,44,44,44,44,44,26,44,44
44,44,44,0,44,44,44,44,44,40,41,44,44,15,44,44
44,44,3,4,2,44,44,44,44,18,19,44,44,44,44,44
44,44,44,1,44,44,44,44,44,44,44,44,44,44,44,44
44,44,44,44,44,44,44,44,44,44,44,44,44,44,44,44
44,44,44,44,44,44,44,44,44,44,44,44,44,44,44,44
44,44,44,44,44,44,44,44,44,44,44,44,44,44,44,44
44,44,44,44,44,44,44,44,44,44,44,44,44,44,44,44
44,44,44,27,44,44,37,44,44,28,29,44,32,33,23,25
38,39,44,44,44,38,36,39,44,30,31,44,34,35,24,24
5,5,5,5,5,5,5,5,5,5,5,5,5,5,5,5
4,4,4,4,4,4,4,4,4,4,4,4,4,4,4,4
