6,44,44,12,5,5,5,5,5,5,5,6,44,44,44,44
6,44,44,11,7,7,7,7,7,7,7,6,44,44,44,44
6,44,40,44,40,44,44,44,44,44,44,14,44,44,44,44
6,44,44,44,44,44,44,44,44,44,44,14,44,44,44,44
4,13,17,44,16,17,44,44,44,44,44,14,44,44,44,44
6,44,44,44,44,44,44,44,44,44,44,14,44,44,44,44
6,44,44,44,44,44,44,44,44,44,44,14,44,44,44,44
6,44,22,44,44,40,28,29,40,44,44,14,44,44,44,44
6,44,44,44,44,44,30,31,44,44,44,14,44,44,44,44
6,44,44,44,44,44,44,44,44,44,44,14,44,44,44,44
6,41,44,41,44,44,44,44,44,44,44,14,44,44,44,44
4,13,13,17,44,44,44,44,44,44,44,14,44,44,44,44
6,44,44,44,44,44,44,42,42,42,44,14,44,44,44,44
6,44,44,44,44,44,44,42,22,42,44,14,44,44,44,44
6,44,44,42,42,42,44,42,42,42,44,14,44,44,44,44
