6,44,44,44,44,44,44,44,44,44,44,14,44,44,44,44
6,44,44,44,44,44,44,44,44,44,44,14,44,44,44,44
6,44,44,44,44,44,44,44,44,44,44,14,44,44,44,44
6,44,44,44,44,44,44,44,44,44,44,14,44,44,44,44
6,44,44,44,44,44,44,44,44,44,44,14,44,44,44,44
6,44,44,44,44,44,44,44,44,44,44,14,44,44,44,44
6,44,44,44,44,44,44,44,44,44,44,14,44,44,44,44
6,42,42,42,42,42,44,44,44,44,44,14,44,44,44,44
6,23,25,42,42,42,44,44,44,44,44,14,44,44,44,44
6,24,24,42,42,42,44,44,44,44,44,14,44,44,44,44
6,13,13,13,13,13,13,13,21,44,44,14,44,44,44,44
6,44,44,44,44,44,44,1,1,44,44,14,44,44,44,44
6,44,44,44,44,44,44,44,44,44,44,14,44,44,44,44
6,44,44,44,44,44,15,44,44,44,44,14,44,44,44,44
6,44,44,0,0,0,0,0,0,0,0,14,44,44,44,44
